11111111111
1P000000001
10C00E01001
10010C01001
11111111111
