1111111111
1000000001
100M00E001
1000000C01
100P00C001
1011111111
1000000001
1111111101
1000000001
1111111111