1111111111
1000000001
100M0C0E01
1000000001
1011111111
1000000001
11111111C1
1P00000001
1111111111