1111111111111111111111111111
100000000000C11C0000000000E1
1011110111111111111110111101
101111011111C11C111110111101
1011110111110110111110111101
1C10000M00000000000000M000C1
1111110111110110111110111111
1C11110111110110111110111101
1000000100000110000010M00001
1111110101111111111010111111
1P00000000000000MC00000000M1
1111111111111111111111111111